7
XXXXXXX
X.....X
X.XSX.X
X.....X
X.....X
XFXXXXX
XXXXXXX