5
XXXXX
XXSXX
XX.XX
XXFXX
XXXXX